%%%%%%%%%%%%%%
%............%
%.....P......%
%............%
%%%%%%%%%%%%%%
